#########################################
#    O#     #           #         #     #
# ##### ### # ##### # ### ### ### ##### #
# #     #   #   #   # #     # #   #   # #
# # ##### # ### # ##### ##### # ### # # #
#       # # #   #       #     #     # # #
######### # # ########### ########### # #
#   #   # # # #     # #   # #       #   #
# # # # # ### ### # # # ### # # ####### #
# #   #   #   #   # # # #   # # #   #   #
# ####### # ### ### # # ### # # # # # ###
#       # #     # # # #   #   #   #   # #
# ##### ######### # # ### # ########### #
# #   # #     #   #     # #       #     #
# # ### # # ### # ##### # ####### ##### #
#   #   # #   # #       # #     #   #   #
### # ### ### # ######### ##### ### # ###
#   #   #   # # #       #     # #   #   #
# ##### ### # # ##### # ##### # # ### # #
#     #     # # #     #   #   #   #   # #
# ####### ### # # # ####### ##### ##### #
# #     #   # # # # #     # #   #   #   #
# # ### ### # # # # ##### # # # ### # # #
# # # # #   # #   # #   # #   # # # # # #
### # # ##### ##### # # # # ### # # # # #
#   # #           # # # # #   # # # # # #
# ### ########### # ### # ### # # # # # #
#   #   #         #   # # #   # # #   # #
# # # ### ########### # # ##### # ##### #
# # #   #           #   #   #   # #   # #
### # # # ##### ####### ### # ### # # # #
#   # #   #   # #       #   # # #   #   #
# ######### # # # ####### ### # # #######
#   #   #   # # # # #     #   #     #   #
# # # # # ### # # # # ##### # ##### # # #
# #   #   # # # #   # #     # #   # # # #
# ######### # # # ### # # ##### # # ### #
#       #   # # # #   # #       # #     #
####### # # # ### # ############# ##### #
#         # #     #               #     #
#########################################
